,Rk,Team,G,MP,FG,FGA,FG_PCT,3P,3PA,3P_PCT,2P,2PA,2P_PCT,FT,FTA,FT_PCT,ORB,DRB,TRB,AST,STL,BLK,TOV,PF,PTS
2019-20,1,Dallas Mavericks,67,16180,2787,6027,0.462,1026,2779,0.369,1761,3248,0.542,1196,1548,0.773,712,2438,3150,1640,419,334,857,1276,7796
2019-20,2,Milwaukee Bucks,65,15650,2830,5928,0.477,893,2510,0.356,1937,3418,0.567,1159,1562,0.742,617,2745,3362,1685,480,390,969,1247,7712
2019-20,3,Houston Rockets,64,15435,2632,5803,0.454,986,2832,0.348,1646,2971,0.554,1310,1664,0.787,663,2212,2875,1375,541,329,939,1382,7560
2019-20,4,Portland Trail Blazers,66,15890,2763,5998,0.461,829,2228,0.372,1934,3770,0.513,1145,1434,0.798,666,2335,3001,1333,401,411,858,1412,7500
2019-20,5,Atlanta Hawks,67,16280,2723,6067,0.449,805,2416,0.333,1918,3651,0.525,1237,1566,0.79,661,2237,2898,1605,523,341,1086,1548,7488
2019-20,6,New Orleans Pelicans,64,15510,2729,5902,0.462,896,2409,0.372,1833,3493,0.525,1082,1485,0.729,719,2290,3009,1728,486,328,1038,1345,7436
2019-20,7,Los Angeles Clippers,64,15435,2664,5739,0.464,778,2123,0.366,1886,3616,0.522,1330,1679,0.792,701,2368,3069,1526,456,318,946,1411,7436
2019-20,8,Washington Wizards,64,15435,2682,5821,0.461,788,2117,0.372,1894,3704,0.511,1247,1584,0.787,644,2024,2668,1621,519,273,900,1445,7399
2019-20,9,Memphis Grizzlies,65,15625,2779,5913,0.47,710,2019,0.352,2069,3894,0.531,1053,1384,0.761,679,2357,3036,1757,520,363,992,1354,7321
2019-20,10,Phoenix Suns,65,15675,2650,5709,0.464,727,2061,0.353,1923,3648,0.527,1289,1560,0.826,637,2163,2800,1766,507,261,980,1439,7316
2019-20,11,Miami Heat,65,15825,2576,5486,0.47,868,2265,0.383,1708,3221,0.53,1270,1633,0.778,552,2343,2895,1689,480,291,968,1323,7290
2019-20,12,Minnesota Timberwolves,64,15560,2586,5865,0.441,853,2540,0.336,1733,3325,0.521,1223,1624,0.753,675,2193,2868,1525,555,362,981,1370,7248
2019-20,13,Boston Celtics,64,15485,2634,5735,0.459,794,2190,0.363,1840,3545,0.519,1170,1461,0.801,683,2259,2942,1459,529,358,873,1367,7232
2019-20,14,Toronto Raptors,64,15460,2596,5665,0.458,880,2369,0.371,1716,3296,0.521,1159,1448,0.8,618,2275,2893,1624,565,316,924,1376,7231
2019-20,15,Los Angeles Lakers,63,15170,2704,5579,0.485,703,1981,0.355,2001,3598,0.556,1092,1496,0.73,668,2239,2907,1630,541,430,951,1299,7203
2019-20,16,Denver Nuggets,65,15750,2719,5778,0.471,707,1977,0.358,2012,3801,0.529,1031,1330,0.775,699,2179,2878,1724,529,302,890,1303,7176
2019-20,17,San Antonio Spurs,63,15295,2649,5638,0.47,671,1809,0.371,1978,3829,0.517,1160,1434,0.809,555,2244,2799,1546,454,345,773,1212,7129
2019-20,18,Philadelphia 76ers,65,15675,2651,5701,0.465,742,2052,0.362,1909,3649,0.523,1079,1435,0.752,673,2282,2955,1682,531,349,923,1342,7123
2019-20,19,Indiana Pacers,65,15700,2740,5744,0.477,648,1787,0.363,2092,3957,0.529,979,1244,0.787,573,2211,2784,1686,470,334,853,1274,7107
2019-20,20,Utah Jazz,64,15385,2569,5413,0.475,843,2200,0.383,1726,3213,0.537,1125,1457,0.772,566,2320,2886,1419,377,256,954,1281,7106
2019-20,21,Oklahoma City Thunder,64,15460,2578,5447,0.473,666,1878,0.355,1912,3569,0.536,1267,1589,0.797,517,2213,2730,1400,487,321,861,1205,7089
2019-20,22,Brooklyn Nets,64,15560,2558,5763,0.444,824,2423,0.34,1734,3340,0.519,1149,1545,0.744,694,2409,3103,1539,413,292,993,1322,7089
2019-20,23,Detroit Pistons,66,15965,2595,5658,0.459,791,2157,0.367,1804,3501,0.515,1097,1476,0.743,644,2109,2753,1589,490,299,1008,1299,7078
2019-20,24,New York Knicks,66,15965,2638,5896,0.447,631,1872,0.337,2007,4024,0.499,1076,1550,0.694,795,2274,3069,1456,504,313,946,1464,6983
2019-20,25,Sacramento Kings,64,15510,2583,5622,0.459,808,2219,0.364,1775,3403,0.522,1001,1302,0.769,616,2104,2720,1497,488,271,922,1400,6975
2019-20,26,Cleveland Cavaliers,65,15725,2619,5715,0.458,727,2070,0.351,1892,3645,0.519,983,1296,0.758,704,2172,2876,1500,447,211,1073,1188,6948
2019-20,27,Chicago Bulls,65,15675,2573,5762,0.447,793,2282,0.348,1780,3480,0.511,1006,1332,0.755,680,2041,2721,1510,652,265,1005,1417,6945
2019-20,28,Orlando Magic,65,15625,2550,5773,0.442,710,2080,0.341,1840,3693,0.498,1104,1434,0.77,674,2220,2894,1559,543,372,820,1145,6914
2019-20,29,Golden State Warriors,65,15725,2510,5730,0.438,678,2032,0.334,1832,3698,0.495,1214,1511,0.803,647,2138,2785,1663,534,299,969,1304,6912
2019-20,30,Charlotte Hornets,65,15750,2425,5586,0.434,785,2231,0.352,1640,3355,0.489,1052,1406,0.748,715,2066,2781,1549,428,268,949,1223,6687
2018-19,1,Milwaukee Bucks,82,19780,3555,7471,0.476,1105,3134,0.353,2450,4337,0.565,1471,1904,0.773,762,3316,4078,2136,615,486,1137,1608,9686
2018-19,2,Golden State Warriors,82,19805,3612,7361,0.491,1087,2824,0.385,2525,4537,0.557,1339,1672,0.801,797,2990,3787,2413,625,525,1169,1757,9650
2018-19,3,New Orleans Pelicans,82,19755,3581,7563,0.473,842,2449,0.344,2739,5114,0.536,1462,1921,0.761,909,2969,3878,2216,610,441,1215,1732,9466
2018-19,4,Philadelphia 76ers,82,19805,3407,7233,0.471,889,2474,0.359,2518,4759,0.529,1742,2258,0.771,892,3025,3917,2207,606,432,1223,1745,9445
2018-19,5,Los Angeles Clippers,82,19830,3384,7178,0.471,821,2118,0.388,2563,5060,0.507,1853,2340,0.792,796,2936,3732,1970,561,385,1193,1913,9442
2018-19,6,Portland Trail Blazers,82,19855,3470,7427,0.467,904,2520,0.359,2566,4907,0.523,1558,1914,0.814,967,2968,3935,1887,546,413,1135,1669,9402
2018-19,7,Oklahoma City Thunder,82,19855,3497,7706,0.454,932,2677,0.348,2565,5029,0.51,1461,2049,0.713,1031,2911,3942,1917,766,425,1145,1839,9387
2018-19,8,Toronto Raptors,82,19880,3460,7305,0.474,1015,2771,0.366,2445,4534,0.539,1449,1803,0.804,786,2920,3706,2085,680,437,1150,1724,9384
2018-19,9,Sacramento Kings,82,19730,3541,7637,0.464,927,2455,0.378,2614,5182,0.504,1354,1865,0.726,906,2819,3725,2083,679,363,1095,1751,9363
2018-19,10,Washington Wizards,82,19930,3456,7387,0.468,930,2731,0.341,2526,4656,0.543,1508,1963,0.768,794,2679,3473,2154,683,379,1154,1701,9350
2018-19,11,Houston Rockets,82,19830,3218,7163,0.449,1323,3721,0.356,1895,3442,0.551,1582,2001,0.791,836,2613,3449,1741,700,405,1094,1803,9341
2018-19,12,Atlanta Hawks,82,19855,3392,7524,0.451,1067,3034,0.352,2325,4490,0.518,1443,1918,0.752,955,2825,3780,2118,675,419,1397,1932,9294
2018-19,13,Minnesota Timberwolves,82,19830,3413,7483,0.456,827,2357,0.351,2586,5126,0.504,1570,1995,0.787,923,2750,3673,2018,683,411,1074,1664,9223
2018-19,14,Boston Celtics,82,19780,3451,7423,0.465,1032,2829,0.365,2419,4594,0.527,1282,1598,0.802,804,2849,3653,2155,706,435,1052,1670,9216
2018-19,15,Brooklyn Nets,82,19980,3301,7358,0.449,1047,2965,0.353,2254,4393,0.513,1555,2088,0.745,900,2919,3819,1954,539,339,1236,1763,9204
2018-19,16,Los Angeles Lakers,82,19780,3491,7425,0.47,847,2541,0.333,2644,4884,0.541,1336,1910,0.699,835,2985,3820,2096,618,440,1284,1701,9165
2018-19,17,Utah Jazz,82,19755,3314,7082,0.468,993,2789,0.356,2321,4293,0.541,1540,2092,0.736,820,2981,3801,2133,663,483,1240,1728,9161
2018-19,18,San Antonio Spurs,82,19805,3468,7248,0.478,812,2071,0.392,2656,5177,0.513,1408,1720,0.819,757,2910,3667,2013,501,386,992,1487,9156
2018-19,19,Charlotte Hornets,82,19830,3297,7362,0.448,977,2783,0.351,2320,4579,0.507,1510,1895,0.797,814,2778,3592,1905,591,405,1001,1550,9081
2018-19,20,Denver Nuggets,82,19730,3439,7384,0.466,903,2571,0.351,2536,4813,0.527,1294,1714,0.755,972,2832,3804,2245,634,363,1102,1644,9075
2018-19,21,Dallas Mavericks,82,19780,3182,7122,0.447,1022,3002,0.34,2160,4120,0.524,1541,2076,0.742,832,2884,3716,1918,533,351,1167,1650,8927
2018-19,22,Indiana Pacers,82,19705,3390,7135,0.475,779,2081,0.374,2611,5054,0.517,1298,1727,0.752,762,2766,3528,2128,713,404,1122,1594,8857
2018-19,23,Phoenix Suns,82,19880,3289,7164,0.459,790,2400,0.329,2499,4764,0.525,1447,1858,0.779,748,2563,3311,1957,735,418,1279,1932,8815
2018-19,24,Orlando Magic,82,19780,3316,7307,0.454,937,2633,0.356,2379,4674,0.509,1231,1575,0.782,822,2902,3724,2095,543,445,1082,1526,8800
2018-19,25,Detroit Pistons,82,19855,3185,7238,0.44,993,2854,0.348,2192,4384,0.5,1415,1893,0.747,936,2752,3688,1845,569,331,1135,1811,8778
2018-19,26,Miami Heat,82,19730,3251,7218,0.45,928,2658,0.349,2323,4560,0.509,1238,1782,0.695,921,2879,3800,1991,627,448,1208,1712,8668
2018-19,27,Chicago Bulls,82,19905,3266,7205,0.453,745,2123,0.351,2521,5082,0.496,1328,1695,0.783,718,2799,3517,1796,603,351,1159,1663,8605
2018-19,28,New York Knicks,82,19780,3134,7241,0.433,823,2421,0.34,2311,4820,0.479,1484,1956,0.759,857,2811,3668,1646,557,422,1151,1713,8575
2018-19,29,Cleveland Cavaliers,82,19755,3189,7184,0.444,847,2388,0.355,2342,4796,0.488,1342,1694,0.792,879,2619,3498,1698,534,195,1106,1642,8567
2018-19,30,Memphis Grizzlies,82,19880,3113,6924,0.45,811,2368,0.342,2302,4556,0.505,1453,1882,0.772,723,2703,3426,1963,684,448,1147,1801,8490
2017-18,1,Golden State Warriors,82,19730,3509,6981,0.503,926,2370,0.391,2583,4611,0.56,1360,1668,0.815,691,2877,3568,2402,656,612,1267,1607,9304
2017-18,2,Houston Rockets,82,19755,3174,6906,0.46,1256,3470,0.362,1918,3436,0.558,1609,2061,0.781,739,2825,3564,1767,699,392,1135,1597,9213
2017-18,3,New Orleans Pelicans,82,19955,3500,7241,0.483,837,2312,0.362,2663,4929,0.54,1324,1716,0.772,712,2924,3636,2195,657,485,1223,1570,9161
2017-18,4,Toronto Raptors,82,19830,3383,7169,0.472,968,2705,0.358,2415,4464,0.541,1422,1790,0.794,800,2807,3607,1995,626,500,1095,1783,9156
2017-18,5,Cleveland Cavaliers,82,19730,3311,6950,0.476,981,2636,0.372,2330,4314,0.54,1488,1909,0.779,694,2761,3455,1916,582,312,1126,1524,9091
2017-18,6,Denver Nuggets,82,19880,3338,7102,0.47,940,2536,0.371,2398,4566,0.525,1404,1830,0.767,902,2748,3650,2059,627,404,1227,1533,9020
2017-18,7,Philadelphia 76ers,82,19780,3349,7098,0.472,901,2445,0.369,2448,4653,0.526,1405,1868,0.752,893,2996,3889,2221,682,420,1353,1811,9004
2017-18,8,Minnesota Timberwolves,82,19805,3365,7063,0.476,658,1845,0.357,2707,5218,0.519,1592,1980,0.804,848,2593,3441,1861,689,345,1021,1495,8980
2017-18,9,Los Angeles Clippers,82,19705,3302,7004,0.471,777,2196,0.354,2525,4808,0.525,1556,2095,0.743,832,2766,3598,1832,628,373,1204,1638,8937
2017-18,10,Charlotte Hornets,82,19780,3197,7106,0.45,824,2233,0.369,2373,4873,0.487,1656,2216,0.747,827,2901,3728,1770,559,373,1041,1409,8874
2017-18,11,Los Angeles Lakers,82,19905,3338,7248,0.461,822,2384,0.345,2516,4864,0.517,1364,1910,0.714,876,2927,3803,1949,633,388,1295,1736,8862
2017-18,12,Oklahoma City Thunder,82,19830,3271,7221,0.453,881,2491,0.354,2390,4730,0.505,1421,1985,0.716,1024,2671,3695,1750,743,412,1147,1653,8844
2017-18,13,Washington Wizards,82,19855,3275,7018,0.467,814,2173,0.375,2461,4845,0.508,1378,1786,0.772,823,2713,3536,2065,645,353,1196,1746,8742
2017-18,14,Brooklyn Nets,82,19855,3136,7114,0.441,1041,2924,0.356,2095,4190,0.5,1428,1850,0.772,792,2852,3644,1941,512,390,1245,1688,8741
2017-18,15,Milwaukee Bucks,82,19830,3257,6807,0.478,718,2024,0.355,2539,4783,0.531,1499,1915,0.783,688,2579,3267,1905,722,443,1134,1752,8731
2017-18,16,Portland Trail Blazers,82,19755,3222,7132,0.452,845,2308,0.366,2377,4824,0.493,1372,1715,0.8,835,2893,3728,1599,573,423,1109,1599,8661
2017-18,17,Indiana Pacers,82,19755,3345,7083,0.472,741,2010,0.369,2604,5073,0.513,1225,1573,0.779,788,2684,3472,1819,721,340,1089,1544,8656
2017-18,18,New York Knicks,82,19830,3334,7193,0.464,673,1914,0.352,2661,5279,0.504,1225,1557,0.787,859,2752,3611,1912,552,421,1207,1682,8566
2017-18,19,Utah Jazz,82,19755,3139,6797,0.462,887,2425,0.366,2252,4372,0.515,1375,1766,0.779,740,2807,3547,1839,708,420,1205,1608,8540
2017-18,20,Boston Celtics,82,19805,3141,6975,0.45,939,2492,0.377,2202,4483,0.491,1308,1697,0.771,767,2878,3645,1842,604,373,1149,1618,8529
2017-18,21,Phoenix Suns,82,19705,3153,7141,0.442,763,2286,0.334,2390,4855,0.492,1453,1962,0.741,842,2776,3618,1743,569,370,1289,1807,8522
2017-18,22,Detroit Pistons,82,19805,3208,7129,0.45,886,2373,0.373,2322,4756,0.488,1207,1621,0.745,830,2756,3586,1868,628,317,1103,1508,8509
2017-18,23,Miami Heat,82,19930,3184,6997,0.455,903,2506,0.36,2281,4491,0.508,1209,1601,0.755,763,2801,3564,1862,620,437,1179,1648,8480
2017-18,24,Orlando Magic,82,19730,3182,7042,0.452,844,2405,0.351,2338,4637,0.504,1271,1678,0.757,722,2692,3414,1921,622,400,1192,1579,8479
2017-18,25,Atlanta Hawks,82,19705,3130,7015,0.446,917,2544,0.36,2213,4471,0.495,1298,1654,0.785,743,2693,3436,1946,638,348,1276,1606,8475
2017-18,26,Chicago Bulls,82,19855,3170,7285,0.435,906,2549,0.355,2264,4736,0.478,1194,1574,0.759,790,2873,3663,1923,626,289,1147,1571,8440
2017-18,27,San Antonio Spurs,82,19730,3202,6999,0.457,696,1977,0.352,2506,5022,0.499,1324,1715,0.772,849,2777,3626,1868,628,460,1078,1408,8424
2017-18,28,Dallas Mavericks,82,19805,3128,7042,0.444,967,2688,0.36,2161,4354,0.496,1167,1530,0.763,666,2717,3383,1858,578,310,1008,1578,8390
2017-18,29,Memphis Grizzlies,82,19705,3013,6788,0.444,758,2152,0.352,2255,4636,0.486,1361,1732,0.786,779,2544,3323,1767,613,396,1227,1900,8145
2017-18,30,Sacramento Kings,82,19755,3179,7063,0.45,738,1967,0.375,2441,5096,0.479,1008,1371,0.735,777,2578,3355,1768,643,340,1125,1639,8104
2014-15,1,Golden State Warriors,82,19730,3410,7137,0.478,883,2217,0.398,2527,4920,0.514,1313,1709,0.768,853,2814,3667,2248,762,496,1185,1628,9016
2014-15,2,Los Angeles Clippers,82,19730,3228,6830,0.473,827,2202,0.376,2401,4628,0.519,1468,2067,0.71,784,2711,3495,2031,640,409,1012,1749,8751
2014-15,3,Dallas Mavericks,82,19880,3255,7036,0.463,732,2082,0.352,2523,4954,0.509,1386,1843,0.752,858,2608,3466,1846,663,371,1062,1644,8628
2014-15,4,Toronto Raptors,82,19855,3108,6829,0.455,726,2060,0.352,2382,4769,0.499,1585,2014,0.787,881,2526,3407,1701,615,357,1057,1712,8527
2014-15,5,Oklahoma City Thunder,82,19830,3184,7119,0.447,632,1864,0.339,2552,5255,0.486,1524,2020,0.754,1052,2844,3896,1681,598,454,1205,1829,8524
2014-15,6,Houston Rockets,82,19805,3032,6832,0.444,933,2680,0.348,2099,4152,0.506,1525,2133,0.715,958,2624,3582,1820,777,407,1366,1803,8522
2014-15,7,San Antonio Spurs,82,19955,3208,6854,0.468,677,1847,0.367,2531,5007,0.505,1368,1754,0.78,806,2772,3578,2000,657,444,1146,1564,8461
2014-15,8,Cleveland Cavaliers,82,19780,3089,6739,0.458,826,2253,0.367,2263,4486,0.504,1453,1934,0.751,911,2612,3523,1814,603,340,1171,1510,8457
2014-15,9,Portland Trail Blazers,82,19855,3175,7049,0.45,807,2231,0.362,2368,4818,0.491,1272,1589,0.801,879,2881,3760,1799,525,372,1117,1494,8429
2014-15,10,Atlanta Hawks,82,19730,3121,6699,0.466,818,2152,0.38,2303,4547,0.506,1349,1735,0.778,715,2611,3326,2111,744,380,1167,1457,8409
2014-15,11,Phoenix Suns,82,19880,3178,7038,0.452,698,2048,0.341,2480,4990,0.497,1343,1767,0.76,896,2643,3539,1659,700,385,1238,1744,8397
2014-15,12,Denver Nuggets,82,19880,3099,7158,0.433,660,2032,0.325,2439,5126,0.476,1462,1991,0.734,1012,2653,3665,1788,641,367,1166,1882,8320
2014-15,13,Boston Celtics,82,19880,3193,7211,0.443,660,2021,0.327,2533,5190,0.488,1266,1678,0.754,910,2685,3595,2009,674,294,1133,1738,8312
2014-15,14,Sacramento Kings,82,19855,3010,6617,0.455,461,1350,0.341,2549,5267,0.484,1829,2400,0.762,895,2728,3623,1667,550,324,1333,1696,8310
2014-15,15,Chicago Bulls,82,19880,3001,6797,0.442,645,1825,0.353,2356,4972,0.474,1618,2067,0.783,959,2792,3751,1781,514,476,1145,1495,8265
2014-15,16,New Orleans Pelicans,82,19780,3108,6795,0.457,586,1583,0.37,2522,5212,0.484,1345,1790,0.751,942,2621,3563,1806,553,510,1087,1530,8147
2014-15,17,Washington Wizards,82,19955,3139,6790,0.462,497,1381,0.36,2642,5409,0.488,1305,1758,0.742,862,2801,3663,1969,601,378,1233,1707,8080
2014-15,18,Detroit Pistons,82,19830,3041,7038,0.432,703,2043,0.344,2338,4995,0.468,1292,1838,0.703,1051,2630,3681,1771,623,383,1099,1559,8077
2014-15,19,Los Angeles Lakers,82,19930,3054,7020,0.435,532,1546,0.344,2522,5474,0.461,1433,1935,0.741,952,2647,3599,1715,578,366,1086,1741,8073
2014-15,20,Memphis Grizzlies,82,19905,3097,6763,0.458,423,1246,0.339,2674,5517,0.485,1445,1869,0.773,856,2634,3490,1777,700,347,1094,1567,8062
2014-15,21,Brooklyn Nets,82,19930,3069,6804,0.451,541,1633,0.331,2528,5171,0.489,1359,1817,0.748,846,2627,3473,1716,576,340,1133,1579,8038
2014-15,22,Milwaukee Bucks,82,19930,3083,6722,0.459,545,1500,0.363,2538,5222,0.486,1312,1734,0.757,876,2574,3450,1932,789,403,1373,1814,8023
2014-15,23,Minnesota Timberwolves,82,19805,2986,6820,0.438,406,1223,0.332,2580,5597,0.461,1638,2110,0.776,949,2406,3355,1771,668,327,1231,1571,8016
2014-15,24,Indiana Pacers,82,19855,2998,6824,0.439,612,1740,0.352,2386,5084,0.469,1373,1817,0.756,856,2822,3678,1757,505,375,1147,1742,7981
2014-15,25,Orlando Magic,82,19755,3076,6792,0.453,554,1598,0.347,2522,5194,0.486,1141,1565,0.729,822,2607,3429,1692,647,314,1221,1714,7847
2014-15,26,Utah Jazz,82,19705,2900,6492,0.447,610,1781,0.343,2290,4711,0.486,1391,1929,0.721,988,2617,3605,1632,623,489,1256,1583,7801
2014-15,27,Miami Heat,82,19730,2885,6330,0.456,556,1659,0.335,2329,4671,0.499,1438,1940,0.741,747,2461,3208,1626,642,372,1214,1636,7764
2014-15,28,Charlotte Hornets,82,19905,2913,6932,0.42,498,1566,0.318,2415,5366,0.45,1397,1867,0.748,820,2793,3613,1654,499,448,976,1494,7721
2014-15,29,Philadelphia 76ers,82,19805,2765,6777,0.408,692,2160,0.32,2073,4617,0.449,1320,1953,0.676,978,2536,3514,1683,789,487,1453,1778,7542
2014-15,30,New York Knicks,82,19855,2882,6726,0.428,560,1614,0.347,2322,5112,0.454,1211,1575,0.769,867,2443,3310,1746,575,382,1206,1768,7535
2009-10,1,Phoenix Suns,82,19730,3339,6788,0.492,730,1770,0.412,2609,5018,0.52,1631,2117,0.77,910,2616,3526,1912,479,418,1210,1713,9039
2009-10,2,Golden State Warriors,82,19730,3329,7094,0.469,633,1687,0.375,2696,5407,0.499,1631,2085,0.782,753,2397,3150,1839,761,340,1204,1886,8922
2009-10,3,Denver Nuggets,82,19780,3124,6678,0.468,544,1517,0.359,2580,5161,0.5,1937,2508,0.772,889,2505,3394,1719,683,417,1136,1844,8729
2009-10,4,Utah Jazz,82,19755,3227,6575,0.491,439,1207,0.364,2788,5368,0.519,1654,2233,0.741,872,2588,3460,2187,675,400,1246,1859,8547
2009-10,5,Toronto Raptors,82,19780,3199,6631,0.482,518,1397,0.371,2681,5234,0.512,1618,2118,0.764,806,2507,3313,1804,469,384,1100,1819,8534
2009-10,6,Orlando Magic,82,19730,3005,6394,0.47,841,2241,0.375,2164,4153,0.521,1575,2176,0.724,810,2736,3546,1615,512,456,1155,1629,8426
2009-10,7,Memphis Grizzlies,82,19905,3223,6875,0.469,344,1020,0.337,2879,5855,0.492,1614,2202,0.733,1070,2496,3566,1543,645,399,1248,1655,8404
2009-10,8,Houston Rockets,82,19905,3094,6923,0.447,646,1838,0.351,2448,5085,0.481,1561,2022,0.772,971,2471,3442,1790,583,318,1188,1712,8395
2009-10,9,New York Knicks,82,19880,3127,6876,0.455,743,2145,0.346,2384,4731,0.504,1376,1759,0.782,836,2477,3313,1772,586,305,1148,1638,8373
2009-10,10,Cleveland Cavaliers,82,19780,3101,6391,0.485,602,1582,0.381,2499,4809,0.52,1569,2180,0.72,791,2692,3483,1835,564,425,1137,1591,8373
2009-10,11,Dallas Mavericks,82,19880,3140,6760,0.464,558,1498,0.372,2582,5262,0.491,1526,1870,0.816,834,2586,3420,1917,624,449,1059,1563,8364
2009-10,12,Los Angeles Lakers,82,19830,3144,6875,0.457,532,1562,0.341,2612,5313,0.492,1519,1985,0.765,973,2662,3635,1730,612,400,1096,1592,8339
2009-10,13,Atlanta Hawks,82,19855,3181,6801,0.468,524,1455,0.36,2657,5346,0.497,1452,1914,0.759,969,2451,3420,1789,592,413,980,1632,8338
2009-10,14,Oklahoma City Thunder,82,19805,3063,6629,0.462,418,1229,0.34,2645,5400,0.49,1778,2210,0.805,960,2607,3567,1639,654,481,1227,1743,8322
2009-10,15,San Antonio Spurs,82,19780,3150,6659,0.473,554,1547,0.358,2596,5112,0.508,1458,1969,0.74,887,2621,3508,1829,516,381,1116,1669,8312
2009-10,16,Indiana Pacers,82,19705,3020,6823,0.443,659,1896,0.348,2361,4927,0.479,1564,2019,0.775,785,2618,3403,1730,585,439,1232,1848,8263
2009-10,17,New Orleans Hornets,82,19830,3178,6842,0.464,571,1572,0.363,2607,5270,0.495,1293,1661,0.778,852,2450,3302,1828,625,300,1103,1606,8220
2009-10,18,Sacramento Kings,82,19880,3144,6895,0.456,482,1383,0.349,2662,5512,0.483,1430,1969,0.726,977,2518,3495,1679,564,366,1226,1827,8200
2009-10,19,Boston Celtics,82,19780,3039,6294,0.483,499,1433,0.348,2540,4861,0.523,1559,2090,0.746,716,2449,3165,1930,701,402,1219,1816,8136
2009-10,20,Minnesota Timberwolves,82,19780,3106,6923,0.449,403,1181,0.341,2703,5742,0.471,1436,1926,0.746,962,2556,3518,1626,597,306,1333,1699,8051
2009-10,21,Portland Trail Blazers,82,19855,2974,6453,0.461,491,1388,0.354,2483,5065,0.49,1606,2033,0.79,913,2383,3296,1674,523,350,1012,1715,8045
2009-10,22,Philadelphia 76ers,82,19805,3087,6706,0.46,474,1381,0.343,2613,5325,0.491,1366,1808,0.756,941,2421,3362,1723,667,439,1192,1677,8014
2009-10,23,Milwaukee Bucks,82,19980,3050,6998,0.436,645,1813,0.356,2405,5185,0.464,1264,1675,0.755,965,2560,3525,1740,580,385,1085,1823,8009
2009-10,24,Chicago Bulls,82,19905,3081,6825,0.451,352,1066,0.33,2729,5759,0.474,1479,1962,0.754,937,2715,3652,1704,531,478,1175,1648,7993
2009-10,25,Miami Heat,82,19880,2984,6518,0.458,494,1426,0.346,2490,5092,0.489,1452,1931,0.752,875,2553,3428,1548,605,457,1079,1710,7914
2009-10,26,Washington Wizards,82,19830,3008,6700,0.449,432,1225,0.353,2576,5475,0.471,1444,1895,0.762,966,2458,3424,1557,493,421,1219,1752,7892
2009-10,27,Los Angeles Clippers,82,19705,3002,6601,0.455,483,1457,0.332,2519,5144,0.49,1362,1867,0.73,927,2502,3429,1810,532,466,1285,1581,7849
2009-10,28,Charlotte Bobcats,82,19880,2858,6306,0.453,460,1331,0.346,2398,4975,0.482,1637,2180,0.751,858,2490,3348,1658,632,446,1290,1597,7813
2009-10,29,Detroit Pistons,82,19780,2940,6602,0.445,374,1190,0.314,2566,5412,0.474,1455,1998,0.728,1053,2242,3295,1591,596,313,1100,1822,7709
2009-10,30,New Jersey Nets,82,19780,2813,6554,0.429,377,1185,0.318,2436,5369,0.454,1572,2015,0.78,897,2358,3255,1540,573,393,1182,1643,7575
2004-05,1,Phoenix Suns,82,19780,3351,7018,0.477,796,2026,0.393,2555,4992,0.512,1556,2080,0.748,967,2652,3619,1927,572,453,1125,1563,9054
2004-05,2,Sacramento Kings,82,19855,3203,6978,0.459,522,1396,0.374,2681,5582,0.48,1577,2004,0.787,1023,2455,3478,2005,674,316,1073,1685,8505
2004-05,3,Dallas Mavericks,82,19730,3058,6691,0.457,463,1273,0.364,2595,5418,0.479,1826,2314,0.789,990,2530,3520,1610,708,461,1102,1827,8405
2004-05,4,Miami Heat,82,19980,3097,6368,0.486,475,1260,0.377,2622,5108,0.513,1658,2466,0.672,887,2639,3526,1790,528,474,1127,1814,8327
2004-05,5,Boston Celtics,82,19880,3046,6511,0.468,437,1252,0.349,2609,5259,0.496,1775,2323,0.764,909,2438,3347,1810,667,423,1297,2000,8304
2004-05,6,Washington Wizards,82,19780,2966,6794,0.437,514,1498,0.343,2452,5296,0.463,1795,2476,0.725,1133,2374,3507,1563,716,347,1172,1807,8241
2004-05,7,Toronto Raptors,82,19805,2952,6656,0.444,648,1681,0.385,2304,4975,0.463,1626,2101,0.774,844,2444,3288,1670,621,317,1087,1876,8178
2004-05,8,Denver Nuggets,82,19755,3038,6615,0.459,320,940,0.34,2718,5675,0.479,1765,2313,0.763,967,2473,3440,1958,750,489,1224,1878,8161
2004-05,9,Orlando Magic,82,19705,3034,6679,0.454,320,916,0.349,2714,5763,0.471,1772,2335,0.759,1038,2544,3582,1583,633,441,1322,1937,8160
2004-05,10,Philadelphia 76ers,82,19855,2946,6736,0.437,505,1453,0.348,2441,5283,0.462,1731,2194,0.789,909,2536,3445,1710,756,321,1274,1878,8128
2004-05,11,Seattle SuperSonics,82,19755,2882,6498,0.444,666,1824,0.365,2216,4674,0.474,1683,2131,0.79,1041,2311,3352,1487,553,338,1113,1944,8113
2004-05,12,Los Angeles Lakers,82,19780,2895,6629,0.437,644,1813,0.355,2251,4816,0.467,1661,2137,0.777,1028,2511,3539,1672,508,344,1176,1794,8095
2004-05,13,Golden State Warriors,82,19905,3029,7039,0.43,624,1774,0.352,2405,5265,0.457,1412,1955,0.722,1069,2436,3505,1811,642,420,1112,1833,8094
2004-05,14,New York Knicks,82,19880,2978,6599,0.451,441,1240,0.356,2537,5359,0.473,1580,2060,0.767,965,2393,3358,1665,629,260,1204,1942,7977
2004-05,15,Milwaukee Bucks,82,19780,2964,6580,0.45,325,925,0.351,2639,5655,0.467,1720,2229,0.772,985,2405,3390,1720,529,289,1132,1797,7973
2004-05,16,Minnesota Timberwolves,82,19755,3045,6629,0.459,395,1145,0.345,2650,5484,0.483,1449,1820,0.796,947,2580,3527,1918,460,447,1079,1774,7934
2004-05,17,Cleveland Cavaliers,82,19855,2990,6687,0.447,300,904,0.332,2690,5783,0.465,1634,2174,0.752,1117,2352,3469,1851,654,461,1141,1850,7914
2004-05,18,San Antonio Spurs,82,19805,2923,6450,0.453,507,1395,0.363,2416,5055,0.478,1535,2120,0.724,987,2489,3476,1771,613,543,1126,1717,7888
2004-05,19,Los Angeles Clippers,82,20030,2924,6368,0.459,231,669,0.345,2693,5699,0.473,1770,2274,0.778,980,2455,3435,1901,599,422,1290,1819,7849
2004-05,20,Houston Rockets,82,19855,2846,6419,0.443,553,1521,0.364,2293,4898,0.468,1551,1986,0.781,874,2601,3475,1733,563,378,1135,1807,7796
2004-05,21,Chicago Bulls,82,19830,2849,6592,0.432,511,1433,0.357,2338,5159,0.453,1536,2048,0.75,1001,2591,3592,1743,576,369,1371,2028,7745
2004-05,22,Charlotte Bobcats,82,19880,2961,6859,0.432,320,881,0.363,2641,5978,0.442,1487,2096,0.709,1083,2335,3418,1794,695,440,1192,1894,7729
2004-05,23,Memphis Grizzlies,82,19705,2802,6271,0.447,531,1486,0.357,2271,4785,0.475,1526,2024,0.754,887,2307,3194,1716,699,476,1197,1910,7661
2004-05,24,Detroit Pistons,82,19955,2851,6421,0.444,363,1053,0.345,2488,5368,0.463,1588,2150,0.739,1054,2507,3561,1787,576,497,1133,1638,7653
2004-05,25,Indiana Pacers,82,19905,2668,6169,0.432,542,1575,0.344,2126,4594,0.463,1748,2206,0.792,868,2418,3286,1489,615,357,1173,1890,7626
2004-05,26,Utah Jazz,82,19780,2828,6301,0.449,250,762,0.328,2578,5539,0.465,1719,2272,0.757,1047,2243,3290,1826,541,374,1292,2189,7625
2004-05,27,Portland Trail Blazers,82,19730,2896,6422,0.451,420,1161,0.362,2476,5261,0.471,1409,1944,0.725,970,2404,3374,1722,583,544,1308,1703,7621
2004-05,28,Atlanta Hawks,82,19855,2942,6672,0.441,304,973,0.312,2638,5699,0.463,1417,1994,0.711,1100,2335,3435,1614,629,344,1319,2009,7605
2004-05,29,New Jersey Nets,82,19905,2753,6419,0.429,435,1203,0.362,2318,5216,0.444,1555,2039,0.763,855,2387,3242,1772,650,308,1164,1985,7496
2004-05,30,New Orleans Hornets,82,19930,2718,6556,0.415,415,1316,0.315,2303,5240,0.44,1401,1830,0.766,1019,2281,3300,1724,550,310,1217,1883,7252
1999-00,1,Sacramento Kings,82,19805,3276,7288,0.45,534,1656,0.322,2742,5632,0.487,1521,2016,0.754,1056,2635,3691,1953,787,381,1325,1729,8607
1999-00,2,Detroit Pistons,82,19830,3044,6635,0.459,439,1223,0.359,2605,5412,0.481,1956,2506,0.781,917,2458,3375,1707,665,273,1288,2011,8483
1999-00,3,Dallas Mavericks,82,19730,3195,7047,0.453,519,1326,0.391,2676,5721,0.468,1407,1751,0.804,931,2444,3375,1810,592,416,1124,1770,8316
1999-00,4,Indiana Pacers,82,19730,3047,6640,0.459,583,1487,0.392,2464,5153,0.478,1629,2008,0.811,842,2612,3454,1857,559,422,1159,1786,8306
1999-00,5,Milwaukee Bucks,82,19855,3174,6827,0.465,394,1069,0.369,2780,5758,0.483,1558,1982,0.786,1016,2373,3389,1852,671,381,1230,2020,8300
1999-00,6,Los Angeles Lakers,82,19805,3137,6836,0.459,344,1047,0.329,2793,5789,0.482,1649,2368,0.696,1117,2738,3855,1921,613,534,1143,1841,8267
1999-00,7,Orlando Magic,82,19755,3169,7014,0.452,294,870,0.338,2875,6144,0.468,1574,2142,0.735,1145,2540,3685,1709,743,467,1443,1967,8206
1999-00,8,Houston Rockets,82,19830,3001,6664,0.45,581,1625,0.358,2420,5039,0.48,1573,2145,0.733,1008,2586,3594,1774,613,438,1425,1663,8156
1999-00,9,Boston Celtics,82,19730,3054,6880,0.444,417,1260,0.331,2637,5620,0.469,1621,2175,0.745,1108,2420,3528,1741,795,286,1259,2223,8146
1999-00,10,Seattle SuperSonics,82,19780,3108,6946,0.447,546,1611,0.339,2562,5335,0.48,1363,1960,0.695,1042,2483,3525,1878,657,345,1152,1776,8125
1999-00,11,Denver Nuggets,82,19855,3057,6911,0.442,470,1397,0.336,2587,5514,0.469,1531,2116,0.724,1073,2590,3663,1911,554,618,1281,1962,8115
1999-00,12,Phoenix Suns,82,19805,3093,6771,0.457,458,1246,0.368,2635,5525,0.477,1467,1934,0.759,1022,2558,3580,2098,744,433,1368,1973,8111
1999-00,13,Minnesota Timberwolves,82,19905,3226,6910,0.467,248,716,0.346,2978,6194,0.481,1379,1769,0.78,1016,2471,3487,2205,622,444,1139,1913,8079
1999-00,14,Charlotte Hornets,82,19780,2935,6533,0.449,339,1001,0.339,2596,5532,0.469,1863,2458,0.758,884,2635,3519,2023,732,480,1206,1670,8072
1999-00,15,New Jersey Nets,82,19830,2979,6881,0.433,477,1374,0.347,2502,5507,0.454,1601,2041,0.784,1040,2315,3355,1688,720,393,1119,1913,8036
1999-00,16,Portland Trail Blazers,82,19780,3021,6430,0.47,407,1128,0.361,2614,5302,0.493,1542,2029,0.76,966,2560,3526,1925,633,396,1243,1865,7991
1999-00,17,Toronto Raptors,82,19755,2980,6882,0.433,425,1171,0.363,2555,5711,0.447,1583,2068,0.765,1098,2449,3547,1947,666,544,1137,1989,7968
1999-00,18,Cleveland Cavaliers,82,19855,2977,6734,0.442,343,919,0.373,2634,5815,0.453,1653,2205,0.75,1010,2499,3509,1941,715,363,1427,2219,7950
1999-00,19,Washington Wizards,82,19805,3010,6681,0.451,335,890,0.376,2675,5791,0.462,1566,2107,0.743,1064,2438,3502,1771,593,383,1320,2149,7921
1999-00,20,Utah Jazz,82,19755,2962,6380,0.464,329,854,0.385,2633,5526,0.476,1661,2150,0.773,936,2426,3362,2041,629,446,1220,2013,7914
1999-00,21,San Antonio Spurs,82,19855,2952,6393,0.462,330,882,0.374,2622,5511,0.476,1652,2214,0.746,927,2666,3593,1819,614,551,1233,1716,7886
1999-00,22,Golden State Warriors,82,19755,2996,7140,0.42,345,1069,0.323,2651,6071,0.437,1497,2147,0.697,1300,2438,3738,1851,731,356,1302,2043,7834
1999-00,23,Philadelphia 76ers,82,19830,2993,6776,0.442,208,643,0.323,2785,6133,0.454,1577,2226,0.708,1147,2468,3615,1817,791,386,1284,1939,7771
1999-00,24,Miami Heat,82,19830,2974,6462,0.46,446,1202,0.371,2528,5260,0.481,1345,1827,0.736,921,2619,3540,1931,582,524,1231,1947,7739
1999-00,25,Atlanta Hawks,82,19830,3000,6807,0.441,258,814,0.317,2742,5993,0.458,1477,1987,0.743,1146,2570,3716,1548,500,461,1266,1718,7735
1999-00,26,Vancouver Grizzlies,82,19855,2892,6441,0.449,324,898,0.361,2568,5543,0.463,1594,2060,0.774,1005,2324,3329,1700,608,346,1381,1881,7702
1999-00,27,New York Knicks,82,19830,2897,6374,0.455,351,937,0.375,2546,5437,0.468,1410,1805,0.781,802,2521,3323,1588,515,349,1201,1983,7555
1999-00,28,Los Angeles Clippers,82,19705,2877,6757,0.426,429,1267,0.339,2448,5490,0.446,1363,1826,0.746,955,2377,3332,1479,578,494,1325,1821,7546
1999-00,29,Chicago Bulls,82,19805,2565,6180,0.415,340,1032,0.329,2225,5148,0.432,1482,2089,0.709,1032,2323,3355,1645,646,383,1557,1908,6952
1994-95,1,Orlando Magic,82,19930,3460,6899,0.502,523,1412,0.37,2937,5487,0.535,1648,2465,0.669,1149,2457,3606,2281,672,488,1297,1726,9091
1994-95,2,Phoenix Suns,82,19830,3356,6967,0.482,584,1584,0.369,2772,5383,0.515,1777,2352,0.756,1027,2403,3430,2198,687,312,1167,1839,9073
1994-95,3,Seattle SuperSonics,82,19830,3310,6741,0.491,491,1305,0.376,2819,5436,0.519,1944,2564,0.758,1068,2337,3405,2115,917,392,1295,2067,9055
1994-95,4,San Antonio Spurs,82,19855,3236,6687,0.484,434,1158,0.375,2802,5529,0.507,1836,2487,0.738,1029,2661,3690,1919,656,456,1246,1871,8742
1994-95,5,Utah Jazz,82,19780,3243,6339,0.512,301,801,0.376,2942,5538,0.531,1939,2483,0.781,874,2412,3286,2256,758,392,1289,2045,8726
1994-95,6,Golden State Warriors,82,19905,3217,6873,0.468,546,1602,0.341,2671,5271,0.507,1687,2395,0.704,1101,2371,3472,2017,649,391,1497,1804,8667
1994-95,7,Los Angeles Lakers,82,19905,3284,7088,0.463,525,1492,0.352,2759,5596,0.493,1523,2072,0.735,1126,2316,3442,2078,750,563,1243,1933,8616
1994-95,8,Houston Rockets,82,19730,3159,6579,0.48,646,1757,0.368,2513,4822,0.521,1527,2039,0.749,880,2440,3320,2060,721,514,1322,1714,8491
1994-95,9,Dallas Mavericks,82,19930,3227,7342,0.44,386,1200,0.322,2841,6142,0.463,1622,2210,0.734,1514,2433,3947,1941,579,348,1345,1811,8462
1994-95,10,Portland Trail Blazers,82,19705,3217,7134,0.451,462,1266,0.365,2755,5868,0.469,1555,2230,0.697,1352,2443,3795,1846,668,467,1212,2024,8451
1994-95,11,Boston Celtics,82,19805,3179,6847,0.464,362,984,0.368,2817,5863,0.48,1708,2268,0.753,1156,2320,3476,1783,612,361,1305,1975,8428
1994-95,12,Chicago Bulls,82,19830,3191,6710,0.476,443,1187,0.373,2748,5523,0.498,1500,2065,0.726,1106,2294,3400,1970,797,352,1297,1962,8325
1994-95,13,Denver Nuggets,82,19980,3098,6461,0.479,413,1160,0.356,2685,5301,0.507,1700,2305,0.738,1040,2402,3442,1836,660,585,1381,2063,8309
1994-95,14,Miami Heat,82,19805,3144,6738,0.467,436,1182,0.369,2708,5556,0.487,1569,2133,0.736,1092,2272,3364,1779,662,298,1291,2000,8293
1994-95,15,Charlotte Hornets,82,19805,3051,6438,0.474,560,1409,0.397,2491,5029,0.495,1587,2042,0.777,832,2395,3227,2072,620,399,1224,1685,8249
1994-95,16,Washington Bullets,82,19855,3176,6899,0.46,433,1264,0.343,2743,5635,0.487,1457,2013,0.724,1044,2219,3263,1749,648,404,1301,1949,8242
1994-95,17,Milwaukee Bucks,82,19855,3022,6586,0.459,494,1349,0.366,2528,5237,0.483,1608,2259,0.712,1063,2187,3250,1737,674,359,1393,1858,8146
1994-95,18,Indiana Pacers,82,19780,2983,6248,0.477,374,985,0.38,2609,5263,0.496,1796,2390,0.751,1051,2290,3341,1877,703,363,1340,1939,8136
1994-95,19,Sacramento Kings,82,19855,3025,6463,0.468,359,1037,0.346,2666,5426,0.491,1647,2317,0.711,1073,2325,3398,1824,650,457,1449,2040,8056
1994-95,20,New York Knicks,82,19780,2985,6394,0.467,532,1446,0.368,2453,4948,0.496,1552,2114,0.734,929,2473,3402,2055,591,387,1305,2102,8054
1994-95,21,Detroit Pistons,82,19730,3060,6633,0.461,494,1396,0.354,2566,5237,0.49,1439,1941,0.741,958,2204,3162,1872,705,420,1318,2151,8053
1994-95,22,New Jersey Nets,82,19880,2939,6738,0.436,414,1297,0.319,2525,5441,0.464,1750,2305,0.759,1213,2569,3782,1884,544,548,1300,1844,8042
1994-95,23,Los Angeles Clippers,82,19880,3060,6888,0.444,331,1051,0.315,2729,5837,0.468,1476,2079,0.71,1064,2076,3140,1805,787,435,1334,2152,7927
1994-95,24,Atlanta Hawks,82,19855,2986,6680,0.447,539,1580,0.341,2447,5100,0.48,1410,1948,0.724,1104,2272,3376,1757,738,412,1221,1804,7921
1994-95,25,Philadelphia 76ers,82,19805,2949,6577,0.448,355,936,0.379,2594,5641,0.46,1567,2125,0.737,1105,2230,3335,1566,643,576,1355,1835,7820
1994-95,26,Minnesota Timberwolves,82,19780,2792,6219,0.449,318,1016,0.313,2474,5203,0.475,1824,2355,0.775,883,2090,2973,1780,609,402,1400,2074,7726
1994-95,27,Cleveland Cavaliers,82,19930,2756,6255,0.441,398,1033,0.385,2358,5222,0.452,1507,1982,0.76,1045,2237,3282,1672,630,349,1176,1694,7417
1989-90,1,Golden State Warriors,82,19705,3489,7208,0.484,243,750,0.324,3246,6458,0.503,2313,2858,0.809,915,2385,3300,1978,756,488,1415,2010,9534
1989-90,2,Phoenix Suns,82,19855,3544,7139,0.496,176,543,0.324,3368,6596,0.511,2159,2716,0.795,1053,2651,3704,2109,668,501,1275,1825,9423
1989-90,3,Denver Nuggets,82,19805,3716,8015,0.464,228,677,0.337,3488,7338,0.475,1737,2201,0.789,1169,2532,3701,2275,814,329,1136,2047,9397
1989-90,4,Portland Trail Blazers,82,19880,3572,7547,0.473,190,565,0.336,3382,6982,0.484,2031,2734,0.743,1355,2552,3907,2085,749,364,1356,2048,9365
1989-90,5,Orlando Magic,82,19805,3457,7525,0.459,116,393,0.295,3341,7132,0.468,2060,2725,0.756,1304,2465,3769,1993,617,294,1407,1975,9090
1989-90,6,Los Angeles Lakers,82,19855,3434,7010,0.49,309,841,0.367,3125,6169,0.507,1902,2417,0.787,1097,2460,3557,2232,655,445,1226,1737,9079
1989-90,7,Philadelphia 76ers,82,19805,3437,7028,0.489,189,543,0.348,3248,6485,0.501,1976,2509,0.788,1111,2406,3517,1932,687,365,1209,1697,9039
1989-90,8,Boston Celtics,82,19705,3563,7148,0.498,106,404,0.262,3457,6744,0.513,1791,2153,0.832,1066,2707,3773,2423,539,455,1256,1717,9023
1989-90,9,Chicago Bulls,82,19830,3531,7090,0.498,250,669,0.374,3281,6421,0.511,1665,2140,0.778,1075,2279,3354,2172,814,388,1247,1906,8977
1989-90,10,Indiana Pacers,82,19880,3381,6807,0.497,294,770,0.382,3087,6037,0.511,1906,2335,0.816,940,2388,3328,2023,552,350,1342,1972,8962
1989-90,11,Atlanta Hawks,82,19730,3417,7019,0.487,124,411,0.302,3293,6608,0.498,1943,2544,0.764,1273,2187,3460,1820,717,353,1270,1871,8901
1989-90,12,New York Knicks,82,19830,3434,7089,0.484,236,710,0.332,3198,6379,0.501,1775,2349,0.756,1187,2426,3613,2140,714,492,1412,1828,8879
1989-90,13,Washington Bullets,82,19830,3598,7581,0.475,37,197,0.188,3561,7384,0.482,1599,2093,0.764,1198,2450,3648,2214,561,424,1201,1929,8832
1989-90,14,Seattle SuperSonics,82,19905,3466,7243,0.479,231,650,0.355,3235,6593,0.491,1606,2167,0.741,1323,2255,3578,1874,701,335,1336,2064,8769
1989-90,15,Utah Jazz,82,19830,3330,6593,0.505,226,630,0.359,3104,5963,0.521,1874,2484,0.754,953,2501,3454,2212,677,491,1410,2031,8760
1989-90,16,Houston Rockets,82,19805,3483,7250,0.48,153,491,0.312,3330,6759,0.493,1633,2267,0.72,1217,2638,3855,2194,809,551,1513,1934,8752
1989-90,17,San Antonio Spurs,82,19730,3388,6997,0.484,54,226,0.239,3334,6771,0.492,1888,2535,0.745,1163,2474,3637,2037,799,554,1399,1854,8718
1989-90,18,Milwaukee Bucks,82,19830,3380,7146,0.473,209,670,0.312,3171,6476,0.49,1722,2273,0.758,1108,2246,3354,2046,826,326,1315,2086,8691
1989-90,19,Detroit Pistons,82,19805,3333,6980,0.478,177,541,0.327,3156,6439,0.49,1713,2252,0.761,1185,2458,3643,1996,512,418,1233,1961,8556
1989-90,20,Los Angeles Clippers,82,19805,3319,6853,0.484,56,230,0.243,3263,6623,0.493,1815,2458,0.738,1056,2362,3418,1978,782,507,1547,1859,8509
1989-90,21,Cleveland Cavaliers,82,19880,3214,6977,0.461,346,851,0.407,2868,6126,0.468,1637,2201,0.744,1128,2380,3508,2106,645,512,1243,1666,8411
1989-90,22,Dallas Mavericks,82,19855,3246,6831,0.475,157,486,0.323,3089,6345,0.487,1735,2261,0.767,1042,2419,3461,1776,664,398,1228,1733,8384
1989-90,23,Sacramento Kings,82,19755,3305,7056,0.468,216,649,0.333,3089,6407,0.482,1515,1964,0.771,952,2363,3315,2052,546,392,1239,1863,8341
1989-90,24,Miami Heat,82,19730,3383,7345,0.461,88,300,0.293,3295,7045,0.468,1393,2028,0.687,1242,2313,3555,1957,736,388,1557,2123,8247
1989-90,25,Charlotte Hornets,82,19755,3270,7183,0.455,205,611,0.336,3065,6572,0.466,1487,1967,0.756,962,2211,3173,2080,778,262,1226,1889,8232
1989-90,26,New Jersey Nets,82,19705,3157,7415,0.426,140,506,0.277,3017,6909,0.437,1754,2350,0.746,1363,2324,3687,1475,774,481,1360,1952,8208
1989-90,27,Minnesota Timberwolves,82,19855,3067,6876,0.446,73,294,0.248,2994,6582,0.455,1596,2137,0.747,1196,2053,3249,1844,789,344,1197,1901,7803
